//MAP CONVERTED BY dmm2tgm.py THIS HEADER COMMENT PREVENTS RECONVERSION, DO NOT REMOVE
"a" = (
/turf/template_noop,
/area/space)
"d" = (
/obj/structure/chair/comfy/shuttle,
/obj/machinery/light{
	bulb_colour = "#3fa69f";
	dir = 1
	},
/turf/open/floor/talos/concrete/line,
/area/shuttle/mining)
"f" = (
/obj/structure/chair/comfy/shuttle{
	dir = 4
	},
/turf/open/floor/talos/concrete/line,
/area/shuttle/mining)
"g" = (
/obj/structure/table,
/turf/open/floor/talos/concrete/triside,
/area/shuttle/mining)
"h" = (
/turf/open/floor/talos/concrete/small,
/area/shuttle/mining)
"i" = (
/turf/closed/wall/mineral/titanium/survival/pod{
	name = "wall"
	},
/area/shuttle/mining)
"j" = (
/obj/structure/shuttle/engine/heater,
/obj/structure/window/reinforced/survival_pod{
	dir = 1
	},
/obj/structure/window/reinforced/survival_pod{
	dir = 4
	},
/turf/open/floor/circuit,
/area/shuttle/mining)
"k" = (
/obj/structure/closet/crate,
/turf/open/floor/talos/concrete/tri,
/area/shuttle/mining)
"v" = (
/obj/machinery/light{
	bulb_colour = "#3fa69f"
	},
/turf/open/floor/talos/concrete,
/area/shuttle/mining)
"w" = (
/obj/structure/table,
/turf/open/floor/talos/concrete/tri,
/area/shuttle/mining)
"x" = (
/obj/docking_port/mobile{
	dir = 8;
	dwidth = 3;
	height = 7;
	id = "mining";
	name = "mining shuttle";
	port_direction = 4;
	width = 7
	},
/obj/machinery/door/airlock/survival_pod/glass{
	dir = 4
	},
/turf/open/floor/plating,
/area/shuttle/mining)
"y" = (
/turf/open/floor/talos/concrete/triside,
/area/shuttle/mining)
"F" = (
/obj/structure/ore_box,
/turf/open/floor/talos/concrete/line,
/area/shuttle/mining)
"G" = (
/obj/structure/shuttle/engine/heater,
/obj/structure/window/reinforced/survival_pod{
	dir = 1
	},
/obj/structure/window/reinforced/survival_pod{
	dir = 8
	},
/turf/open/floor/circuit,
/area/shuttle/mining)
"H" = (
/obj/structure/window/shuttle/survival_pod,
/turf/open/floor/plating,
/area/shuttle/mining)
"P" = (
/obj/machinery/computer/shuttle/mining{
	icon = 'icons/obj/terminals.dmi';
	icon_state = "dorm_available"
	},
/turf/closed/wall/mineral/titanium/survival/pod{
	name = "wall"
	},
/area/shuttle/mining)
"Q" = (
/turf/open/floor/talos/concrete,
/area/shuttle/mining)
"V" = (
/obj/structure/shuttle/engine/propulsion/burst,
/turf/closed/wall/mineral/titanium/survival/pod{
	name = "wall"
	},
/area/shuttle/mining)

(1,1,1) = {"
a
i
H
i
H
i
a
"}
(2,1,1) = {"
i
i
f
g
f
i
i
"}
(3,1,1) = {"
i
d
Q
h
v
j
V
"}
(4,1,1) = {"
H
w
h
P
h
k
H
"}
(5,1,1) = {"
i
d
Q
h
v
G
V
"}
(6,1,1) = {"
i
i
F
y
F
i
i
"}
(7,1,1) = {"
a
i
H
x
H
i
a
"}
